
██████╗  █████╗ ████████╗ ██████╗██╗  ██╗██████╗  ██████╗ ██╗  ██╗     ██████╗ ███████╗
██╔══██╗██╔══██╗╚══██╔══╝██╔════╝██║  ██║██╔══██╗██╔═══██╗╚██╗██╔╝    ██╔═══██╗██╔════╝
██████╔╝███████║   ██║   ██║     ███████║██████╔╝██║   ██║ ╚███╔╝     ██║   ██║███████╗
██╔═══╝ ██╔══██║   ██║   ██║     ██╔══██║██╔══██╗██║   ██║ ██╔██╗     ██║   ██║╚════██║
██║     ██║  ██║   ██║   ╚██████╗██║  ██║██████╔╝╚██████╔╝██╔╝ ██╗    ╚██████╔╝███████║
╚═╝     ╚═╝  ╚═╝   ╚═╝    ╚═════╝╚═╝  ╚═╝╚═════╝  ╚═════╝ ╚═╝  ╚═╝     ╚═════╝ ╚══════╝

Run `sudo patchbox-config` to customize. Run `startx` to start the graphical environment.
